NO img/wn.png
SO img/ws.png
WE img/ww.png
EA img/we.png

F 50,50,50
C 0,0,0

                       1111111
                       100001
                       100001
11111111111111111      100001
10000010000000001      100001
10001000100110001      100001
11111111100010001111111100001111111111111
10101000000000000000000000000000000000001
10000000010110001111111100000000000010001
10101000010010001      100000000001110001
11101111111110001      100000000000010001
10000000000000001      111111111111110001
100000N0100000001                   10001
11111111111111111                   10001
                          111111111110001
                          100000000000001
                          111111111100001
                                   111111
