
NO img/wn.png
SO img/ws.png
WE img/ww.png
EA img/we.png

F 64,64,64
C 135,206,235


111111111111111
1      1      1
1             1
1      1      1
1     1 1     1
1    1   1    1
1   1     1   1
1      S      1
1   1     1   1
1    1   1    1
1     1 1     1
1      1      1
1             1
1      1      1
111111111111111
