NO img/wn.png
SO img/ws.png
WE img/ww.png
EA img/we.png

C 135,206,235
F 19,133,16

    1111111111111111111111111
    1000000000110000000000001
    1011000001110000000011111
1111100000000000000000001
111111111011000001110000111111111
100000000011000001110111111111111
11110111111111011100000010001
11110111111111011101010010001
11000000110101011100000010001
1000N000000000001100000010001
10000000000000001101010010001
1100000111010101111101111000111
11110111 1110101 101111010001
11111111 1111111 111111111111
