
NO img/wn.png
SO img/ws.png
WE img/ww.png
EA img/we.png

F 161,133,148
C 127,181,181


1111111111
1        1
1        1
1    11111
1    1   1
1  E 1   1
1        1
11111 1111
1        1
1        1
1111111111
