NO img/wall_no.png
SO img/wall_so.png
WE img/wall_west.png
EA img/wall_east.png

F 144, 128, 111
C 111, 127, 144

        1111111111111111111111111
        1000000000110000000000001
        1011000001110000000000111
        10010000000000000000001
1111111110110000011100000000101
1000000000110000011101111111111
11110111111111011100000010001
11110111111111011101010010001
11000000000101011100000010001
10000000100000001100000010001
10000000000000001101010010001
11000001110101011111011110011
1111N111 1110101 101111010001
11111111 1111111 111111111111
