
NO img/wall_no.png
SO img/wall_so.png
WE img/wall_west.png
EA img/wall_east.png

F 64,64,64
C 135,206,235


111111111111111
1      1      1
1      1      1
1      1      1
1     1 1     1
1    1   1    1
1   1     1   1
1   1  S  1   1
1   1     1   1
1    1   1    1
1     1 1     1
1      1      1
1      1      1
1      1      1
111111111111111
