
NO img/wall_no.png
SO img/wall_so.png
WE img/wall_west.png
EA img/wall_east.png

F 124,252,0
C 135,206,235

111111111
1       1
1       1
1       1
1   N   1
1       1
1       1
1       1
111111111
