NO img/test/north_64.png
SO img/test/south_64.png
WE img/test/white_64.png
EA img/test/east_64.png

C 120,180,250
F 20,142,255
      111111111111111111
       10000000000000001
111111110000000000000001
100000010111111111111001
10000000000000001   1001
100000 0000000001   1001
100000000000000011111111
10001111110000001
10001    100000011111111111111111111
100011111100000000000000000000000001
10N0 0000000000010000111111111111111
1111111111111111100001
                100001
                100001
                111111