NO img/wn.png
SO img/ws.png
WE img/ww.png
EA img/we.png

F 190,178,123
C 135,299,235

11111111111111111
10000000000000001
10000000000110001
10000000000010001
10000000000000001
10000000E00000001
10000000000000001
10000000000000001
10000000000000001
10000000100000001
11111111111111110