NO img/wn.png
SO img/ws.png
WE img/ww.png
EA img/we.png
NO img/wn.png

F 115, 2, 12
C 38, 1, 1

11111111111111111
10000000000000001
10000000000110001
10000000000010001
10000000000000001
10000000E00000001
11111111111111111

