NO img/wn.png
SO img/ws.png
WE img/ww.png
EA img/we.png

C 225,30,0
C 225,30,0

11111111111111111111
10000000010000100001
10111100000000000011
10000000110001110111
10111000010001110001
10101000010001110111
100010000W0000000011
11111111111111111111
