NO textures/Test1.png
SO textures/Test2.png
WE textures/Test3.png
EA textures/Test4.png

F 190,178,123
C 135,206,235

11111111111111111
10000000000000001
10000000000110001
10000000000010001
10000000000000001
10000000E00000001
11111111111111111

10000000000000001
10000000000000001
10000000000000001
10000000100000001
11111111111111111