NO img/wn.png
SO img/ws.png
WE img/ww.png
EA img/we.png

F 144, 128, 111
C 111, 127, 144

        1111111111111111111111111
        1000000000110000000000001
        1011000001111D11100000111
        10010000000000000000001
1111111110110000011100000000101
1000000000110000011101D11111111
11110000000000011100000000001
1111011D111D11011101010010001
11000000000101011100000010001
10000000100000001100000010001
10000000000000001101010010001
11000001110101011111011110011
1111N111 1110101 101111010001
11111111 1111111 111111111111
