NO img/wn.png
SO img/ws.png
WE img/ww.png
EA img/we.png

C 225,30,0
F 220,100,0

1111111111111111111111111
1000000000110000000000001
10110011D111111D110000001
1001000000000000000000001
1111111110110000011100001111111
1000000000110000011101111111111
11110111111111011100000010001
11110111111111011101010010001
11000000110101011100000010001
10000000000000001100000010001
10000000000000001101010010001
11000001110101011111011110N01
11110111 1110101 101111010001
11111111111111111111111111111
